acacia-n	tree
acceptance-n	legal
ache-n	pain
acne-n	illness
aeon-n	time
agency-n	socialunit
aircraft-n	vehicle
airplane-n	vehicle
airstream-n	atmospheric
allocation-n	assets
allotment-n	assets
aluminium-n	chemical
anchorage-n	district
anger-n	feeling
anthrax-n	illness
apple-n	fruit
architect-n	creator
arthritis-n	illness
artist-n	creator
assignment-n	legal
asthma-n	illness
aurora-n	atmospheric
automobile-n	vehicle
baccarat-n	game
backache-n	pain
ball-n	occasion
banana-n	fruit
basketball-n	game
beano-n	game
bear-n	animal
bellyache-n	pain
berry-n	fruit
bicycle-n	vehicle
bill-n	legal
bismuth-n	chemical
blast-n	atmospheric
boat-n	vehicle
bond-n	legal
borderland-n	district
borough-n	district
bowling-n	game
branch-n	socialunit
brigade-n	socialunit
builder-n	creator
bull-n	animal
bureau-n	socialunit
burn-n	pain
cadmium-n	chemical
calcium-n	chemical
caliphate-n	district
camel-n	animal
cancer-n	illness
canton-n	district
capital-n	assets
car-n	vehicle
carbon-n	chemical
casuarina-n	tree
cat-n	animal
celebration-n	occasion
cent-n	monetary
ceremony-n	occasion
charcoal-n	chemical
check-n	legal
cheque-n	legal
cherry-n	fruit
chess-n	game
chestnut-n	tree
chill-n	physical
cholera-n	illness
cinchona-n	tree
cirrhosis-n	illness
city-n	district
clemency-n	atmospheric
cloud-n	atmospheric
cloudburst-n	atmospheric
club-n	socialunit
coco-n	tree
commemoration-n	occasion
commencement-n	occasion
committee-n	socialunit
company-n	socialunit
compulsion-n	motivation
concavity-n	solid
confederacy-n	socialunit
conifer-n	tree
conscience-n	motivation
constitution-n	legal
constructor-n	creator
convention-n	legal
coolness-n	physical
copper-n	chemical
cordoba-n	monetary
corner-n	solid
coronation-n	occasion
country-n	district
county-n	district
cow-n	animal
craftsman-n	creator
credit-n	assets
crinkle-n	solid
crosswind-n	atmospheric
cruiser-n	vehicle
cube-n	solid
cuboid-n	solid
curling-n	game
cyclone-n	atmospheric
cylinder-n	solid
dance-n	occasion
date-n	time
day-n	time
decree-n	legal
deer-n	animal
deflection-n	physical
department-n	socialunit
designer-n	creator
desire-n	feeling
deterrence-n	motivation
developer-n	creator
diabetes-n	illness
diameter-n	physical
dinar-n	monetary
dirham-n	monetary
disincentive-n	motivation
dispensation-n	assets
divan-n	socialunit
dodecahedron-n	solid
dog-n	animal
dollar-n	monetary
dome-n	solid
drachma-n	monetary
draft-n	legal
drizzle-n	atmospheric
droop-n	solid
dynamic-n	motivation
earache-n	pain
eczema-n	illness
elephant-n	animal
enthronement-n	occasion
epoch-n	time
escudo-n	monetary
ethics-n	motivation
extension-n	physical
family-n	socialunit
farmer-n	creator
faro-n	game
fear-n	feeling
feast-n	occasion
fen-n	monetary
fete-n	occasion
fiesta-n	occasion
fig-n	tree
floater-n	legal
flu-n	illness
fluting-n	solid
fog-n	atmospheric
football-n	game
franc-n	monetary
fund-n	assets
fundraiser-n	occasion
funeral-n	occasion
future-n	time
gain-n	assets
germanium-n	chemical
gestation-n	time
glaucoma-n	illness
glow-n	physical
gold-n	assets
golf-n	game
graduation-n	occasion
grape-n	fruit
guilder-n	monetary
handball-n	game
happiness-n	feeling
headache-n	pain
heaviness-n	physical
helicopter-n	vehicle
helium-n	chemical
hepatitis-n	illness
hereafter-n	time
hoard-n	assets
hornbeam-n	tree
horse-n	animal
house-n	socialunit
household-n	socialunit
hurricane-n	atmospheric
hydrogen-n	chemical
icosahedron-n	solid
impulse-n	motivation
inaugural-n	occasion
incentive-n	motivation
incitement-n	motivation
income-n	assets
indentation-n	solid
inducement-n	motivation
interest-n	assets
inventor-n	creator
investment-n	assets
iron-n	chemical
jacaranda-n	tree
jag-n	solid
joy-n	feeling
keno-n	game
kingdom-n	district
kitten-n	animal
kiwi-n	fruit
knob-n	solid
land-n	district
law-n	legal
league-n	socialunit
legion-n	socialunit
lemon-n	fruit
length-n	physical
leukemia-n	illness
licence-n	legal
life-n	motivation
lightning-n	atmospheric
lime-n	tree
lion-n	animal
lira-n	monetary
lithium-n	chemical
lotto-n	game
love-n	feeling
lumbago-n	pain
magnesium-n	chemical
maker-n	creator
malnutrition-n	illness
mandarin-n	tree
mango-n	fruit
mangrove-n	tree
mania-n	motivation
manufacturer-n	creator
margin-n	assets
mark-n	monetary
mass-n	physical
melon-n	fruit
meningitis-n	illness
menopause-n	time
metropolis-n	district
migraine-n	pain
moment-n	time
momentum-n	physical
monkey-n	animal
morality-n	motivation
mortgage-n	assets
motivator-n	motivation
motorcycle-n	vehicle
mouse-n	animal
musician-n	creator
nap-n	game
nation-n	socialunit
neon-n	chemical
neuralgia-n	pain
nitrogen-n	chemical
nonce-n	time
oak-n	tree
obligation-n	legal
obsession-n	motivation
occasion-n	motivation
octahedron-n	solid
office-n	socialunit
olive-n	fruit
opinion-n	legal
orange-n	fruit
originator-n	creator
ovoid-n	solid
oxygen-n	chemical
oyster-n	animal
pageantry-n	occasion
pain-n	feeling
painter-n	creator
palm-n	tree
parish-n	district
party-n	occasion
passion-n	feeling
payoff-n	assets
peach-n	fruit
pear-n	fruit
penny-n	monetary
period-n	time
peso-n	monetary
photographer-n	creator
pickup-n	vehicle
pine-n	tree
pineapple-n	fruit
pistachio-n	tree
plague-n	illness
plasticity-n	physical
platinum-n	chemical
platoon-n	socialunit
pleasure-n	feeling
possession-n	motivation
potassium-n	chemical
pound-n	monetary
poundage-n	physical
prefecture-n	district
producer-n	creator
profit-n	assets
prom-n	occasion
puppy-n	animal
quaternary-n	time
quota-n	assets
radius-n	physical
raffle-n	game
rainstorm-n	atmospheric
rat-n	animal
rededication-n	occasion
reflexion-n	physical
rescript-n	legal
rheumatism-n	illness
riel-n	monetary
ring-n	solid
riverside-n	district
rocket-n	vehicle
rouble-n	monetary
rowan-n	tree
rugby-n	game
rupee-n	monetary
sadness-n	feeling
salient-n	solid
samba-n	tree
sandstorm-n	atmospheric
sapling-n	tree
sciatica-n	pain
seafront-n	district
sensitivity-n	feeling
sequestration-n	legal
shame-n	feeling
share-n	legal
sheep-n	animal
shilling-n	monetary
ship-n	vehicle
shire-n	district
shortness-n	physical
shower-n	atmospheric
silver-n	chemical
smallpox-n	illness
snap-n	physical
snowfall-n	atmospheric
soccer-n	game
softball-n	game
soreness-n	pain
state-n	district
statute-n	legal
sting-n	pain
stinging-n	pain
stitch-n	pain
straddle-n	legal
strawberry-n	fruit
stretch-n	physical
suburb-n	district
suffering-n	pain
sultanate-n	district
superego-n	motivation
sycamore-n	tree
tailor-n	creator
taper-n	solid
taxation-n	assets
team-n	socialunit
temperature-n	physical
tenderness-n	pain
tennis-n	game
tetrahedron-n	solid
throb-n	pain
thunderstorm-n	atmospheric
tiger-n	animal
titanium-n	chemical
today-n	time
tomorrow-n	time
tonight-n	time
toothache-n	pain
torment-n	pain
tornado-n	atmospheric
town-n	district
treaty-n	legal
tribe-n	socialunit
troop-n	socialunit
trove-n	assets
truck-n	vehicle
turtle-n	animal
twister-n	atmospheric
typhoon-n	atmospheric
urge-n	motivation
van-n	vehicle
venture-n	assets
village-n	district
visibility-n	physical
volleyball-n	game
wager-n	assets
walnut-n	tree
wanderlust-n	motivation
watermelon-n	fruit
wedding-n	occasion
weight-n	physical
whist-n	game
wind-n	atmospheric
wonder-n	feeling
yesterday-n	time
yesteryear-n	time
yuan-n	monetary
zebra-n	animal
zinc-n	chemical
zloty-n	monetary
